16 12
8 8 8 8 8 8 8 8 8  8 8 8 8 8 8 8
8 8 8 8 8 8 8 8 8  8 9 9 9 9 8 8
8 8 8 8 8 8 8 8 8  8 0 8 8 0 8 8
8 4 4 4 4 4 4 8 8 13 0 9 8 9 9 8
8 4 4 4 4 4 8 8 8  8 0 2 8 8 9 8
8 8 8 8 8 8 8 8 8  8 2 0 2 0 9 8
8 8 8 8 8 8 8 8 8  8 0 0 2 2 9 8
8 8 8 8 8 8 8 9 0  2 0 2 2 0 9 8
8 8 8 8 8 8 8 9 2  2 2 1 0 8 9 8
8 8 8 8 8 8 8 9 2  0 8 8 0 8 9 8
8 8 8 8 8 8 8 9 9  9 9 9 9 9 9 8
8 8 8 8 8 8 8 8 8  8 8 8 8 8 8 8
