9 9
8 8 8 8 8 8 8 8 8
8 8 8 8 8 0 0 8 8
8 0 2 0 0 0 2 8 8
8 0 0 4 8 4 0 8 8
8 8 0 8 8 8 0 8 8
8 8 0 4 8 4 0 0 8
8 8 2 0 1 0 2 0 8
8 8 0 0 8 8 8 8 8
8 8 8 8 8 8 8 8 8
