9 8
8 8 8 8 8 8 8 8 8
8 8 0 0 8 8 8 8 8
8 8 4 1 8 8 8 8 8
8 0 4 2 8 8 8 8 8
8 0 2 2 0 2 0 0 8
8 0 4 4 0 0 0 0 8
8 8 8 8 0 0 8 8 8
8 8 8 8 8 8 8 8 8
