10 6
8 8 8 8 8 8 8 8 8 8
8 8 0 0 8 8 0 0 0 8
8 8 0 0 6 0 0 8 0 8
8 0 4 2 8 6 1 0 0 8
8 0 0 0 6 0 0 0 8 8
8 8 8 8 8 8 8 8 8 8
