8 8
8 8 8 8 8 8 8 8
8 8 8 0 0 8 8 8
8 0 0 0 4 0 0 8
8 0 0 2 0 2 0 8
8 8 4 8 5 8 4 8
8 8 0 2 0 2 0 8
8 8 8 8 0 0 8 8
8 8 8 8 8 8 8 8
