8 8
8 8 8 8 8 8 8 8
8 8 0 0 0 8 8 8
8 8 0 8 0 8 8 8
8 8 0 6 0 0 8 8
8 0 2 6 2 0 0 8
8 0 0 6 0 8 0 8
8 8 0 4 0 0 5 8
8 8 8 8 8 8 8 8
