9 9
8 8 8 8 8 8 8 8 8
8 8 8 8 8 8 0 0 8
8 8 0 2 0 2 0 0 8
8 8 4 8 0 8 4 0 8
8 8 0 2 1 2 0 8 8
8 8 4 8 0 8 4 8 8
8 0 0 6 0 6 0 0 8
8 0 0 0 8 0 0 0 8
8 8 8 8 8 8 8 8 8
