16 6
8 8 8 8 8 8 8 8 8 8 8 8 8 8 8 8
8 0 0 8 0 0 8 0 0 8 0 0 8 0 0 8
8 4 2 0 0 0 8 0 0 8 4 2 0 0 0 8
8 0 0 8 4 2 0 4 2 0 0 0 0 0 0 8
8 0 1 8 0 0 8 0 0 8 0 0 0 8 0 8
8 8 8 8 8 8 8 8 8 8 8 8 8 8 8 8
