8 9
8 8 8 8 8 8 8 8 
8 8 8 8 0 0 8 8 
8 0 0 2 0 0 8 8 
8 0 8 2 8 0 0 8 
8 0 0 2 0 0 0 8 
8 4 8 8 8 0 0 8 
8 4 8 8 8 8 0 8 
8 4 0 1 0 0 0 8 
8 8 8 8 8 8 8 8 
