10 6
8 8 8 8 8 8 8 8 8 8
8 8 8 8 8 8 8 0 4 8
8 0 2 0 2 0 2 2 0 8
8 0 0 0 1 0 4 4 4 8
8 8 8 0 0 0 8 8 8 8
8 8 8 8 8 8 8 8 8 8
