10 10
8 8 8 8 8 8 8 8 8 8
8 0 0 0 4 8 8 8 8 8
8 0 4 0 1 8 8 8 8 8
8 0 8 0 8 8 8 8 8 8
8 0 8 0 2 0 8 8 8 8
8 0 6 4 0 0 0 8 8 8
8 8 8 8 0 2 2 0 8 8
8 8 8 8 8 0 0 0 0 8
8 8 8 8 8 8 0 0 0 8
8 8 8 8 8 8 8 8 8 8
