9 7
8 8 8 8 8 8 8 8 8
8 0 0 8 8 8 0 0 8
8 0 2 0 6 0 2 0 8
8 0 0 0 5 0 0 0 8
8 8 8 0 4 2 8 8 8
8 8 8 0 4 0 8 8 8
8 8 8 8 8 8 8 8 8
