# board x y then xy of . blank, Pn piece n, UDLR if stuck on adjacent piece, pieces start at 2
10 10
W    W    W    W    W    W    W    W    W    W
W    .    .    .    .    .    .    .    .    W
W    .    .    .    .    .    .    .    .    W
W    .    .    .    2    2    2S   .    .    W
W    .    .    .    2    3    2    3    .    W
W    .    .    .    .    3    3    3    .    W
W    .    .    .    .    .    .    .    .    W
W    .    .    .    4    4    4    .    .    W
W    .    .    .    .    .    .    .    .    W
W    W    W    W    W    W    W    W    W    W
